key (code reference) = Euskara
manage invites = ikusi jasotako bisitak
save_detail = ibb & obb-en datuak gorde
Loading Trophies = trofeoak kargatzen
testing = probak
Ok = ok
trailpointer hint = Saiatu komunikatzeko eskuineko palanka erabiltzen.
trailpointer hint PC = Saiatu komunikatzeko sagua edo eskuin palanka erabiltzen.
loading all = Beharko duzun guztia kargatzen...
shaman intermezzo = Kaixo ibb, kaixo obb,/nGustura ari al zarete? Espero baietz./nUtzidazu unetxo batez espero dezakezunaren zati bat erakusten./nGero itzuliko naiz zuregana.
Full Zen (name) = Zen Osoa
Party (name) = Festa
All Crystals (name) = Kristal Guztiak
Collection Complete (name) = Bilduma Osatuta
Brain Damage (name) = Burmuin Gaitza
First Crystal (name) = Lehenengo Kristala
Small Zen (name) = Zen Txikia
King Ubb (name) = Ubb Erregea
Quality Time (name) = Kalitatezko Denbora
Fallcrobatics (name) = Erokrobazia
Mint Condition (name) = Akatsi gabe
shaman text = Hello again my friends,/nYou played through a small part of the game and saw some snippets of what still lies ahead./nIf you enjoyed it and feel like more, you can buy the full game in the PlayStation®Store./nHope to see you both again.
play = jokatu
two player = bi jokalari
online game = online partida
invite friend = laguna gonbidatu
single player = bakarrik jokatu
leaderboards = sailkapen taulak
friends = lagunak
local / friends = lagunak
worldwide = mundukoa
buy = joko osoa erosi
credits = kredituak
director = zuzendaria
co-director = zuzendariordea
code lead = kode arduraduna
code = kodea
additional design = diseinu gehigarria
music = musika
sound design = soinu diseinua
animations = animazioz
strategy = estrategia
production = produkzioa
guest artist = artista gonbidatua
Sony Europe = Sony Computer Entertainment Europe
Sony US = Sony Computer Entertainment America
financial support = diruz lagundu du
special thanks = esker bereziak
translations = itzulpenak
ibb and obb names = ibb eta obb izenak
development babies = garapenean zehar jaiotako haurra
back to game = jokora itzuli
restart in limbo = berriro Linboan hasi
Pause_RestartWarning = Berriz Linboan hasi nahi duzu?/nJokoaren aurrerapena galduko da.
exit to main menu = irten menu nagusira
Pause_QuitWarning = Menu nagusira irten nahi duzu?/nJokoaren aurrerapena galduko da.
sound effect volume = soinu efektuen bolumena
music volume = musikaren bolumena
controller rumble = agintearen bibrazioa
use analogue stick to change volume = erabili palanka analogikoa bolumena aldatzeko
title = ibb & obb
ibb = ibb
obb = obb
On = bai
Off = ez
Yes = bai
No = ez
Cancel = ezeztatu
X confirm = \X baieztatu
O back to menu = \O menura itzuli
X select = \X aukeratu
O back = \O itzuli
X select O back = \X aukeratu \O itzuli
P sign in = \P izena eman
back = itzuli
press start = sakatu Start
Chat restricted = Zure Sony Entertainment Network kontuan txata desgaituta /ntxataren murrizketa batzuk direla eta.
Sign-in Prompt = Sony Entertainment Network-en izena eman behar duzu /nfuntzio hau erabiltzeko. /nIzena eman nahi duzu?
Sign-in Reminder = Ezin duzu aukera hau erabili Sony Entertainment Network-en/nizena eman ezean.
Not Own Save Data = Profil honetan gordetako datuak beste erabiltzaile batenak dira. /Trofeoak ezin izango dira desblokeatu eta ezin dira profil /nhonen datuak gorde saioa irekita dagoen bitartean.
Not Own Save Data 2 = Profil honetan gordetako datuak beste erabiltzaile batenak dira. /nSaio honetan ezin izango dituzu datuak gorde. /nHala ere profil hau erabili nahi duzu?
MenuItemDemoText = (demoan ez dago eskuragarri)
Not Allowed Online Services = Zure Sony kontuan online zerbitzuak desgaituta daude gurasoen kontrola dela eta.
playground message = Beste jokalari bat batzea itxaroten...
Indicator Warning = Do not turn off the PlayStation®3 system when the save icon is visible.
InternalError_OtherPlayerLeftTheGame = Beste jokalariarekin konexioa galdu da.
InternalError_UserCancelledInvite = testurik ez
InternalError_NotSignedInPSN = You are no longer signed into PlayStation®Network.
InternalError_PSNInitializationFailed = Unable to initialize connection to PlayStation®Network./nTry restarting the game.
PSNError_Generic = There was an error connecting to PlayStation®Network.
PSNError_ServerUnavailable = The PlayStation®Network is currently unavailable. /nPlease try again later.
PSNError_NotConnected = Error: not connected to PlayStation®Network.
PSNError_InternalServerError = Internal PlayStation®Network server error.
PSNError_ServerBusy = The PlayStation®Network server is currently busy. /nPlease try again later.
PSNError_PlayerBanned = You are banned from the PlayStation®Network server.
PhotonError_Generic = Errorea gertatu da ibb & obb-en multijokalari zerbitzarietara konektatzerakoan.
PhotonError_GameFull = Ezin da jokora gehitu: beteta dago.
PhotonError_GameClosed = Gobidapena ezeztatu da edo jokoa itxita dago.
PhotonError_ServerFull = ibb & obb-en multijokalari zerbitzariak beteta daude. /nMesedez, saia zaitez beranduago.
PhotonError_GameIdAlreadyExists = Joko hau dagoeneko existitzen da ibb & obb-en multijokalari zerbitzarietan.
PSNError_SendFailure = Ezin izan da mezua bidali: /nHartzailea blokeo zerrenda batean dago edo bidalketan sareak huts egin du.
PSNError_TimeOut = Errorea: operazioa iraungi egin da.
PSNError_ServiceUnavailable = Zerbitzua ez dago eskuragarri. Mesedez, saia zaitez beranduago.
Full Zen = Bukatu maila guztiak puntuazio altuenarekin.
Party = Jokatu joko arrunteko maila guztietan.
All Crystals = Bildu maila sekretuetako kristal guztiak.
Collection Complete = Aurkitu levelmen eta secretmen guztiak.
Brain Damage = Bukatu jokoa jokalari bakarrarekin.
First Crystal = Bildu kristal bat maila sekreturen batean.
Small Zen = Bukatu maila bat puntuazio altuenarekin.
King Ubb = Aurkitu ubb eta eraman hurrengo Fin Hirira.
Quality Time = Punpatu Fin alde batera eta bestera ibb eta obb artean 10 aldiz.
Fallcrobatics = 6 irazki desberdinetatik pasa lurra ikutu gabe.
Mint Condition = Bukatu maila bat hil gabe.
invite_message = Kaixo. Jokatu nahi duzu nirekin ibb & obb partida bat?
go to store = go to PlayStation®Store
no online game in demo = Online jokoa: demoan ez dago eskuragarri.
Valve = Valve
local game = partida lokala
settings = ezarpenak
quit = irten
start game = hasi partida
fullscreen = pantaila osoa
antialiasing = ertzak leundu
apply = aplikatu
reset progress = aurrerapena berrezarri
marketing = marketing laguntzailea
voice chat = ahots txata
CRC check failed = <FILE> fitxategia aldatu dela nabaritu dugu./nLorpenak, Sailkapenak, Multijokalaria eta Gordetzea desaktibatuak.
SteamError_Generic = Errore bat gertatu da ibb & obb-en multijokalari zerbitzarietara konektatzerakoan.
press space to return to main menu = sakatu espazio tekla menu nagusira itzultzeko
network status = sarearen egoera
Voice Chat unavailable = Ahots txata eskuraezina
start = hasi
connect online = online konektatu
multiplayer = multijokalaria
connect = konektatu
disconnect = deskonektatu
host = ostalaria
join = batu
start from constants = konstanteetatik hasi
new game = partida berria
continue = jarraitu
local = lokala
network status: Uninitialized = sarearen egoera: Hasieratu gabe
